NO ./north.xpm

SO ./south.xpm

WE ./west.xpm

EA ./east.xpm

F 220,100,0
C 0,127,255

1111111111111111111111111
1000111100001111110100001
1000000000000000000000001
1000001111000001110000111
1000000000000000000000001
1000000000000000000000001
10000W0000000000000000001
1111111111111111111111111
