NO ./north.xpm
SO ./south.xpm

WE ./west.xpm

EA ./east.xpm

F 220,100,0
C 0,127,255

111111110111111111111111
100000000000000000000001
10000000000000001000000111111
10000000000000000000000000001
1111110000N001110000000111111
     1000000001111000001
111111000000001 11000001
100000000000001 11000001
111111111111101 11000001111111111
        1000011111000000000000001
        1000000000000000000000001
        1111111111111111111111111
