NO ./north.xpm
SO ./south.xpm

WE ./west.xpm

EA ./east.xpm

F 220,100,0
C 0,127,255

111111111111111111111111
100000000000000000000001
100000000000000010000001
100000000000000000000001
1111110000N0011100000001
     1000000001111000001
111111000000001 11000001
100000000000001 11000001
111111111111101 110000011
1000011111000000000000001
1000000000000000000000001
1111111111111111111111111
